IGGGMMMMGMMGMMMMGGGJ
E        MM        F
E MMMMMM    MMM MM F
E  M     FE MMG GG F
MM M MM MMM GG  HH F
E     M  FE HH HMM F   
E MMMMMM    MM MMMMM
E       MMH        F
EFM MMM      M MMM F
EFI M    MMM M M   F
EBA M MM   M   MMK F
EDC M    MMMMM   MMM
EFK MM M       M   F
EFM M  MMMMMM MMMK F
E              M   F
MI JMMMMM  MMM MI  F
E     MMM  MMM     F
MMMI   MMEFMM   JMMM
E    M  GABG  M    F
KHHHHMMHHHHHHMMHHHHL