MMMMMMMMMMMMMM
M            M
M MMM MM MMM M
M            M
M  MM MM MM  M
M            M
MM   M  M   MM
M    MMMM    M
M MM M  M MM M
M MM M  M MM M
M MM      MM M
M MM MMMM MM M
M            M
MMMMMMMMMMMMMM