MMMMMMMMMMMMMM
M            M
M MM MMMM MM M
M MM      MM M
M MM M  M MM M
M MM M  M MM M
M    MMMM    M
MM   M  M   MM
M            M
M  MM MM MM  M
M            M
M MMM MM MMM M
M            M
MMMMMMMMMMMMMM